CC = Carbon-copy
CX = Correction
CT = partial retweet
DM = Direct message 
HT = Hat tip 
MT = Modified tweet
PRT = Partial retweet
PRT = Please retweet 
RT = Retweet 
SP = sponsored  
EM = Email Marketing
EZine = Electronic Magazine
FB = Facebook
LI = LinkedIn
SEO = Search Engine Optimization
SM = Social Media
SMM = Social Media Marketing
SMO = Social Media Optimization
SN = Social Network
SROI = Social Return on Investment
UGC = User Generated Content
UX = User Experience
YT = YouTube
AFAIK = As far as I know
AYFKMWTS = Are you fucking kidding me with this shit?
B4 = Before
BFN = Bye for now
BGD = Background
BH = Blockhead
BR = Best regards
BTW = By the way
CD9 = Code 9, parents are around 
CHK = Check
CUL8R = See you later
DAM = Don't annoy me
DD = Dear daughter
DF = Dear fianc√©
DP = used to mean "profile pic"
DS = Dear son
DYK = Did you know, Do you know
EM/EML = Email
EMA = Email address
F2F /FTF = Face to face
FB = Facebook, Fuck buddy
FF = Follow Friday
FFS = For Fuck's Sake
FML = Fuck my life.
FOTD = Find of the day
FTW = For the win, Fuck the world
FUBAR = Fucked up beyond all repair (slang from the US Military)
FWIW = For what it's worth.
GMAFB = Give me a fucking break
GR8 = Great!
GTFOOH = Get the fuck out of here
GTS = Guess the song
HAGN = Have a good night
HAND = Have a nice day
HOTD = Headline of the day
HT = Heard through
HTH = Hope that helps
IC = I see
ICYMI = In case you missed it 
IDK = I don't know
IIRC = If I remember correctly
IMHO = In my humble opinion
IRL = In real life
IWSN = I want sex now
JK = Just kidding 
JS = Just saying
JSYK = Just so you know
JV = Joint venture
KK = Kewl kewl
KYSO = Knock your socks off
LBS = Laughing but Serious
LHH = Laugh hella hard 
LMAO = Laughing my ass off
LMK = Let me know
LO = Little One 
LOL = Laugh out loud
MM = Music Monday
MIRL = Meet in real life 
MRJN = Marijuana
MSM = Main Stream Media 
MTF = More To Follow
NBD = No big deal
NCT = Nobody cares, though
NFI = No Further Information or Not Fuking Interested
NFW = No fuking way
NJoy = Enjoy
NSFW = Not safe for work
NTS = Note to self
OH = Overheard
OMFG = Oh my fuking God
OOMF = One of my friends/followers 
ORLY = Oh, really?
PLMK = Please let me know
PNP = Party and Play drugs and sex
POIDH - Pictures, or it didn't happen
QOTD = quote of the day
RE = In reply to, in regards to
RLRT = Real-life re-tweet 
RTFM = Read the fucking manual
RTQ = Read the question
SFW = Safe for work
SMDH = Shaking my damn head 
SMH = Shaking my head
SNAFU = Situation normal, all fucked up  
SO = Significant Other
S/O = Shout Out
SOB = Son of a Bitch
SRS = Serious
STFU = Shut the fuck up!
STFW = Search the fucking web!
TFTF = Thanks for the follow
TFTT = Thanks for this tweet
TJ = joining a conversation belatedly to contribute to a tangent
TL = Timeline
TMB = Tweet me back
TT = Trending topic
TY = Thank you
TYIA = Thank you in advance
TYT = Take your time
TYVM = Thank you very much
W/E = Whatever  
WTV = Whatever
YGTR = You got that right
YKWIM = You know what I mean
YKYAT = You know you're addicted to 
YMMV = Your mileage may vary
YOLO = You only live once
YOYO = You're on your own 
YW = You're welcome
ZOMG = OMG to the max
#CMAD = Community Manager Appreciation Day
#CMGR = Community Manger topic chat
#FB = The user is sending this post to Facebook
#FF = Follow Friday 
#IN = LinkedIn
#LI = LinkedIn
#LinkedInChat = For general use questions and questions about marketing/self-promotion on LinkedIn
#Mmchat = Marketing and social media chat
#Pinchat = a chat for maximizing Pinterest use
#SocialMedia = an all-inclusive chat for subjects big and small in the subject of Social Media